13 13 4 5 2 60
H H H H H H H H H H H H H
H 1 . S . . . . . S . 2 H
H . H S H . H . H S H . H
H S S . . A . A . . S S H
H . H . H R . R H . H . H
H . . N . . T . . N . . H
H . H . R . B . R . H . H
H . . N . . T . . N . . H
H . H . H R . R H . H . H
H S S . . A . A . . S S H
H . H S H . H . H S H . H
H 3 . S . . . . . S . 4 H
H H H H H H H H H H H H H
