6 9 4 5 1 60
H H H H H H H H H
H 1 . . . . A . H
H . S S . R . . H
H T . 2 . . . N H
H . . . . . . . H
H H H H H H H H H